{
    "width":10,
    "height":10,
    "player1_coordinate":[0,0],
    "player2_coordinate":[0,1],
    "player3_coordinate":[0,2],
    "player4_coordinate":[0,3],
    "treasury_coordinate":[5,5],
    "walls":[[0,0,0,0,0,0,0,1,0,0],
            [0,0,0,0,1,1,1,1,0,0],
            [0,0,0,0,0,0,0,0,0,0],
            [0,0,0,0,0,0,0,0,0,0],
            [0,0,0,0,0,0,0,0,0,0],
            [0,0,0,0,0,0,0,0,0,0],
            [0,0,0,0,0,0,0,0,0,0],
            [0,0,0,0,1,1,1,0,0,0],
            [0,0,0,0,0,1,0,0,0,0],
            [0,0,0,0,0,1,1,1,1,1]],
    "fog_map":[[0,0,0,0,0,0,0,0,0,0],
            [0,0,0,0,0,0,0,0,0,0],
            [0,0,0,0,0,0,0,0,0,0],
            [0,0,0,0,0,0,0,0,0,0],
            [0,0,0,0,0,0,0,0,1,0],
            [0,1,0,0,0,0,0,0,1,0],
            [0,0,1,0,0,0,0,0,1,0],
            [0,0,1,0,0,0,0,0,0,0],
            [0,0,0,0,0,0,0,0,0,0],
            [0,0,0,0,0,0,0,0,0,0]],
     "treasury_map":[[0,0,0,0,0,0,0,0,0,0],
                [0,0,0,0,0,0,0,0,0,0],
                [0,0,0,0,0,0,0,0,0,0],
                [0,0,0,0,0,0,0,0,0,0],
                [0,0,0,0,1,1,1,0,0,0],
                [0,0,0,0,1,1,1,0,0,0],
                [0,0,0,0,1,1,1,0,0,0],
                [0,0,0,0,0,0,0,0,0,0],
                [0,0,0,0,0,0,0,0,0,0],
                [0,0,0,0,0,0,0,0,0,0]]
}