{
    "width":13,
    "height":11,
    "player1_coordinate":[2,1],
    "player2_coordinate":[8,11],
    "player3_coordinate":[8,1],
    "player4_coordinate":[2,11],
    "treasury_coordinate":[5,6],
    "walls":[[0,0,0,0,0,0,1,0,0,0,0,0,0],
             [0,0,0,0,1,1,0,1,1,0,0,0,0],
             [0,0,1,0,0,0,0,0,0,0,1,0,0],
             [0,0,1,1,1,0,0,0,1,1,1,0,0],
             [0,0,0,0,1,0,0,0,1,0,0,0,0],
             [0,0,0,0,1,0,0,0,1,0,0,0,0],
             [0,0,0,0,1,0,0,0,1,0,0,0,0],
             [0,0,1,1,1,0,0,0,1,1,1,0,0],
             [0,0,1,0,0,0,0,0,0,0,1,0,0],
             [0,0,0,0,1,1,0,1,1,0,0,0,0],
             [0,0,0,0,0,0,1,0,0,0,0,0,0]],

    "fog_map":  [[0,0,0,0,0,0,0,0,0,0,0,0,0],
                 [0,0,0,0,0,0,0,0,0,0,0,0,0],
                 [0,0,0,0,0,0,0,0,0,0,0,0,0],
                 [0,0,0,0,0,0,0,0,0,0,0,0,0],
                 [0,0,1,0,0,0,0,0,0,0,1,0,0],
                 [0,0,1,0,0,0,0,0,0,0,1,0,0],
                 [0,0,1,0,0,0,0,0,0,0,1,0,0],
                 [0,0,0,0,0,0,0,0,0,0,0,0,0],
                 [0,0,0,0,0,0,0,0,0,0,0,0,0],
                 [0,0,0,0,0,0,0,0,0,0,0,0,0],
                 [0,0,0,0,0,0,0,0,0,0,0,0,0]],
                 
     "treasury_map":[[0,0,0,0,0,0,0,0,0,0,0,0,0],
                     [0,0,0,0,0,0,0,0,0,0,0,0,0],
                     [0,0,0,0,0,0,0,0,0,0,0,0,0],
                     [0,0,0,0,0,0,0,0,0,0,0,0,0],
                     [0,0,0,0,0,1,1,1,0,0,0,0,0],
                     [0,0,0,0,0,1,1,1,0,0,0,0,0],
                     [0,0,0,0,0,1,1,1,0,0,0,0,0],
                     [0,0,0,0,0,0,0,0,0,0,0,0,0],
                     [0,0,0,0,0,0,0,0,0,0,0,0,0],
                     [0,0,0,0,0,0,0,0,0,0,0,0,0],
                     [0,0,0,0,0,0,0,0,0,0,0,0,0]]
}