{
    "width":17,
    "height":11,
    "player1_coordinate":[0,0],
    "player2_coordinate":[10,16],
    "player3_coordinate":[10,0],
    "player4_coordinate":[0,16],
    "treasury_coordinate":[9,8],
    "walls":[[0,0,1,0,0,0,0,0,1,0,0,0,0,0,1,0,0],
             [0,0,1,0,0,0,0,0,1,0,0,0,0,0,1,0,0],
             [0,0,1,0,0,0,0,0,1,0,0,0,0,0,1,0,0],
             [0,0,1,0,0,1,0,0,1,0,0,1,0,0,1,0,0],
             [0,0,1,0,0,1,0,0,1,0,0,1,0,0,1,0,0],
             [0,0,1,0,0,1,0,0,1,0,0,1,0,0,1,0,0],
             [0,0,1,0,0,1,0,0,1,0,0,1,0,0,1,0,0],
             [0,0,1,0,0,1,0,0,0,0,0,1,0,0,1,0,0],
             [0,0,0,0,0,1,0,0,0,0,0,1,0,0,0,0,0],
             [0,0,0,0,0,1,0,0,0,0,0,1,0,0,0,0,0],
             [0,0,0,0,0,1,0,0,0,0,0,1,0,0,0,0,0]],

    "fog_map":  [[0,0,0,0,0,1,0,0,0,0,0,1,0,0,0,0,0],
                 [0,0,0,0,0,1,0,0,0,0,0,1,0,0,0,0,0],
                 [0,0,0,0,0,1,0,0,0,0,0,1,0,0,0,0,0],
                 [0,0,0,0,0,0,0,0,0,0,0,0,0,0,0,0,0],
                 [0,0,0,0,0,0,0,0,0,0,0,0,0,0,0,0,0],
                 [0,0,0,0,0,0,0,0,0,0,0,0,0,0,0,0,0],
                 [0,0,0,0,0,0,0,0,0,0,0,0,0,0,0,0,0],
                 [0,0,0,0,0,0,0,0,1,0,0,0,0,0,0,0,0],
                 [0,0,1,0,0,0,0,0,0,0,0,0,0,0,1,0,0],
                 [0,0,1,0,0,0,0,0,0,0,0,0,0,0,1,0,0],
                 [0,0,1,0,0,0,0,0,0,0,0,0,0,0,1,0,0]],
                 
     "treasury_map":[[0,0,0,0,0,0,0,0,0,0,0,0,0,0,0,0,0],
                     [0,0,0,0,0,0,0,0,0,0,0,0,0,0,0,0,0],
                     [0,0,0,0,0,0,0,0,0,0,0,0,0,0,0,0,0],
                     [0,0,0,0,0,0,0,0,0,0,0,0,0,0,0,0,0],
                     [0,0,0,0,0,0,0,0,0,0,0,0,0,0,0,0,0],
                     [0,0,0,0,0,0,0,0,0,0,0,0,0,0,0,0,0],
                     [0,0,0,0,0,0,0,0,0,0,0,0,0,0,0,0,0],
                     [0,0,0,0,0,0,0,0,0,0,0,0,0,0,0,0,0],
                     [0,0,0,0,0,0,0,1,1,1,0,0,0,0,0,0,0],
                     [0,0,0,0,0,0,0,1,1,1,0,0,0,0,0,0,0],
                     [0,0,0,0,0,0,0,1,1,1,0,0,0,0,0,0,0]]
}