{
    "width":11,
    "height":11,
    "player1_coordinate":[1,1],
    "player2_coordinate":[1,2],
    "player3_coordinate":[9,1],
    "player4_coordinate":[9,2],
    "treasury_coordinate":[5,9],
    "walls":[[0,0,0,0,0,0,0,0,0,0,0],
             [0,0,0,0,0,0,0,0,0,0,0],
             [0,1,0,0,0,0,0,0,0,0,0],
             [0,1,1,1,0,0,0,0,0,0,0],
             [0,0,0,0,0,0,0,0,0,0,0],
             [0,0,0,0,0,0,0,0,0,0,0],
             [0,0,0,0,0,0,0,0,0,0,0],
             [0,1,1,1,0,0,0,0,0,0,0],
             [0,1,0,0,0,0,0,0,0,0,0],
             [0,0,0,0,0,0,0,0,0,0,0],
             [0,0,0,0,0,0,0,0,0,0,0]],
    "fog_map":[[0,0,0,0,0,0,0,0,0,0,0],
               [0,0,0,0,0,0,0,0,0,0,0],
               [0,0,0,0,0,0,1,1,1,1,1],
               [0,0,0,0,0,0,1,1,1,1,1],
               [0,0,0,0,0,0,1,1,0,0,0],
               [0,0,0,0,0,0,1,1,0,0,0],
               [0,0,0,0,0,0,1,1,0,0,0],
               [0,0,0,0,0,0,1,1,1,1,1],
               [0,0,0,0,0,0,1,1,1,1,1],
               [0,0,0,0,0,0,0,0,0,0,0],
               [0,0,0,0,0,0,0,0,0,0,0]],
     "treasury_map":[[0,0,0,0,0,0,0,0,0,0,0],
                     [0,0,0,0,0,0,0,0,0,0,0],
                     [0,0,0,0,0,0,0,0,0,0,0],
                     [0,0,0,0,0,0,0,0,0,0,0],
                     [0,0,0,0,0,0,0,0,1,1,1],
                     [0,0,0,0,0,0,0,0,1,1,1],
                     [0,0,0,0,0,0,0,0,1,1,1],
                     [0,0,0,0,0,0,0,0,0,0,0],
                     [0,0,0,0,0,0,0,0,0,0,0],
                     [0,0,0,0,0,0,0,0,0,0,0],
                     [0,0,0,0,0,0,0,0,0,0,0]]
}