{
    "width":11,
    "height":11,
    "player1_coordinate":[0,0],
    "player2_coordinate":[10,0],
    "player3_coordinate":[0,10],
    "player4_coordinate":[10,10],
    "treasury_coordinate":[5,5],
    "walls":[[0,0,0,0,0,0,0,0,0,0,0],
             [0,1,1,1,0,0,0,1,1,1,0],
             [0,1,0,0,0,0,0,0,0,1,0],
             [1,1,0,0,0,0,0,0,0,1,1],
             [0,0,0,0,0,0,0,0,0,0,0],
             [0,0,0,0,0,0,0,0,0,0,0],
             [0,0,0,0,0,0,0,0,0,0,0],
             [1,1,0,0,0,0,0,0,0,1,1],
             [0,1,0,0,0,0,0,0,0,1,0],
             [0,1,1,1,0,0,0,1,1,1,0],
             [0,0,0,0,0,0,0,0,0,0,0]],
    "fog_map":[[0,0,0,0,0,0,0,0,0,0,0],
               [0,0,0,0,0,0,0,0,0,0,0],
               [0,0,0,0,0,0,0,0,0,0,0],
               [1,0,0,0,0,0,0,0,0,0,1],
               [0,0,0,0,0,0,0,0,0,0,0],
               [0,0,0,0,0,0,0,0,0,0,0],
               [0,0,0,0,0,0,0,0,0,0,0],
               [1,0,0,0,0,0,0,0,0,0,1],
               [0,0,0,0,0,0,0,0,0,0,0],
               [0,0,0,0,0,0,0,0,0,0,0],
               [0,0,0,0,0,0,0,0,0,0,0]],
     "treasury_map":[[0,0,0,0,0,0,0,0,0,0,0],
                     [0,0,0,0,0,0,0,0,0,0,0],
                     [0,0,0,0,0,0,0,0,0,0,0],
                     [0,0,0,0,0,0,0,0,0,0,0],
                     [0,0,0,0,1,1,1,0,0,0,0],
                     [0,0,0,0,1,1,1,0,0,0,0],
                     [0,0,0,0,1,1,1,0,0,0,0],
                     [0,0,0,0,0,0,0,0,0,0,0],
                     [0,0,0,0,0,0,0,0,0,0,0],
                     [0,0,0,0,0,0,0,0,0,0,0],
                     [0,0,0,0,0,0,0,0,0,0,0]]
}